"filename", "language", "PHP", "JavaScript", "comment", "blank", "total"
"/Users/andrewfoster/Documents/Web_Projects/IG_Internalweb/internalweb/wp-content/plugins/kanbanotron/admin/import_kanbans.php", "PHP", 110, 0, 5, 23, 138
"/Users/andrewfoster/Documents/Web_Projects/IG_Internalweb/internalweb/wp-content/plugins/kanbanotron/components/add_to_purchase_order.php", "PHP", 27, 0, 7, 12, 46
"/Users/andrewfoster/Documents/Web_Projects/IG_Internalweb/internalweb/wp-content/plugins/kanbanotron/components/app.php", "PHP", 23, 0, 2, 4, 29
"/Users/andrewfoster/Documents/Web_Projects/IG_Internalweb/internalweb/wp-content/plugins/kanbanotron/components/initialize.php", "PHP", 70, 0, 3, 19, 92
"/Users/andrewfoster/Documents/Web_Projects/IG_Internalweb/internalweb/wp-content/plugins/kanbanotron/components/load_kanban.php", "PHP", 112, 0, 3, 6, 121
"/Users/andrewfoster/Documents/Web_Projects/IG_Internalweb/internalweb/wp-content/plugins/kanbanotron/components/new_purchase_order.php", "PHP", 40, 0, 2, 11, 53
"/Users/andrewfoster/Documents/Web_Projects/IG_Internalweb/internalweb/wp-content/plugins/kanbanotron/components/purchase_order_preview.php", "PHP", 90, 0, 18, 29, 137
"/Users/andrewfoster/Documents/Web_Projects/IG_Internalweb/internalweb/wp-content/plugins/kanbanotron/components/remove_all_from_purchase_order.php", "PHP", 50, 0, 18, 21, 89
"/Users/andrewfoster/Documents/Web_Projects/IG_Internalweb/internalweb/wp-content/plugins/kanbanotron/components/remove_from_purchase_order.php", "PHP", 24, 0, 4, 10, 38
"/Users/andrewfoster/Documents/Web_Projects/IG_Internalweb/internalweb/wp-content/plugins/kanbanotron/components/send_purchase_order.php", "PHP", 31, 0, 161, 25, 217
"/Users/andrewfoster/Documents/Web_Projects/IG_Internalweb/internalweb/wp-content/plugins/kanbanotron/db/kanbanotron_connection.php", "PHP", 10, 0, 2, 4, 16
"/Users/andrewfoster/Documents/Web_Projects/IG_Internalweb/internalweb/wp-content/plugins/kanbanotron/db/knbn_wp_connection.php", "PHP", 10, 0, 2, 4, 16
"/Users/andrewfoster/Documents/Web_Projects/IG_Internalweb/internalweb/wp-content/plugins/kanbanotron/db/qb_db/items_request.php", "PHP", 27, 0, 3, 8, 38
"/Users/andrewfoster/Documents/Web_Projects/IG_Internalweb/internalweb/wp-content/plugins/kanbanotron/db/qb_db/purchaseorder_update.php", "PHP", 0, 0, 0, 1, 1
"/Users/andrewfoster/Documents/Web_Projects/IG_Internalweb/internalweb/wp-content/plugins/kanbanotron/db/qb_db/purchaseorderlineret_update.php", "PHP", 0, 0, 0, 1, 1
"/Users/andrewfoster/Documents/Web_Projects/IG_Internalweb/internalweb/wp-content/plugins/kanbanotron/db/qb_db/qb_data_connection.php", "PHP", 10, 0, 2, 4, 16
"/Users/andrewfoster/Documents/Web_Projects/IG_Internalweb/internalweb/wp-content/plugins/kanbanotron/db/qb_db/vendor_request.php", "PHP", 0, 0, 0, 1, 1
"/Users/andrewfoster/Documents/Web_Projects/IG_Internalweb/internalweb/wp-content/plugins/kanbanotron/db/request.php", "PHP", 92, 0, 5, 11, 108
"/Users/andrewfoster/Documents/Web_Projects/IG_Internalweb/internalweb/wp-content/plugins/kanbanotron/js/kanbanotron.js", "JavaScript", 0, 109, 10, 22, 141
"/Users/andrewfoster/Documents/Web_Projects/IG_Internalweb/internalweb/wp-content/plugins/kanbanotron/kanbanotron.php", "PHP", 74, 0, 24, 15, 113
"/Users/andrewfoster/Documents/Web_Projects/IG_Internalweb/internalweb/wp-content/plugins/kanbanotron/main.php", "PHP", 12, 0, 0, 2, 14
"Total", "-", 812, 109, 271, 233, 1425